; Floor(.)
; Barrier(#)
; Wall (‡)
; Gate (x)
; One way (< or > or ^ or v)
; Start/Goal (S/G or [a-z]/[A-Z])

[7,8]

>‡‡‡‡‡‡‡‡‡‡‡‡‡‡‡
>‡. . . . . S‡G‡
>‡ ‡‡‡‡‡‡‡‡‡‡‡ ‡
>‡.‡. . . . . .‡
>‡ ‡ ‡‡‡‡‡‡‡‡‡ ‡
>‡.‡.‡#‡#‡#‡#‡.‡
>‡ ‡ ‡‡‡‡‡‡‡‡‡ ‡
>‡.‡.‡#‡#‡#‡#‡.‡
>‡ ‡ ‡‡‡‡‡‡‡‡‡ ‡
>‡.‡. . .‡#‡#‡.‡
>‡ ‡     ‡‡‡‡‡ ‡
>‡.‡. . .‡#‡#‡.‡
>‡ ‡     ‡‡‡‡‡ ‡
>‡.‡. . . . . .‡
>‡ ‡‡‡‡‡‡‡‡‡‡‡ ‡
>‡. . . . . . .‡
>‡‡‡‡‡‡‡‡‡‡‡‡‡‡‡